ا = a
ب = b
پ = p
ت = t
ج = c
چ = ch
ح = h
ھ = h
خ = x
د = d
ر = r
ز = z
ڕ= ra
ژ = j
س = s
ش = sh
ع = e'
غ = xe
ف = f
ڤ = v
ق = q
ک = k
گ = g
ل = l
ڵ = ll
م = m
ن = n
ۆ = o
وو = û
و = u
و = w
ه = e
ی = î 
ێ = ê
٠ = 0
١ = 1
٢ = 2
٣ = 3
٤ = 4
٥ = 5
٦ = 6
٧ = 7
٨ = 8
٩ = 9
سوور=red
ڕەش=black
سپی=white
سەوز=green
شین =blue
مۆر=purple
پرتەقاڵی=orange
قاوەیی=brown
دووشەممە=monday
سێشەممە=tuesday
چوارشەممە=wednesday
پێنج شەممە=thursday
هەینی=friday
شەممە=saturday
یەکشەممە=sunday
کانوونی دووەم=january
شوبات=february
ئازار=march
نیسان=april
ئایار=may
حوزەیران=june
تەمموز=july
ئاب=august
ئەیلوول=september
تشرینی دووەم=november
کانوونی یەکەم=december
بەهار=spring
هاوین=summer
پایز=autumn
زستان=winter
منداڵ=child
باوکە=dad
دایک=mum
کچ=daughter
کوڕ=son
برا=brother
خوشک=sister
دایەگەورە=grandmother
باپیرە=grandfather
مام=uncle
هێشتا=aunt
پوور=aunt
ئامۆزا=cousin
مێرد=husband
هاوسەر=wife
زاوا=groom
بووک=bride
سەر=head
چاو=eyes
گوێ=ear
لووت=nose
دەست=hand
لاق=leg
چەک=arm
پەنجە=finger
دەم=mouth
برۆ=eyebrow
برژانگەکان=eyelashes
قژ=hair
گەدە=stomach
ئەژنۆ=knee
ڕوومەت=cheek
چەناگە=chin
ناوچەوان=forehead
گەروو=throat
زمان=tongue
سێو=apple
مۆز=banana
پرتەقاڵی=orange
ترێی=grape
شلیک=strawberry
شوتی=watermelon
مانگا=manga
ئاناناس=ananas
قۆخ=peach
کیوی=kiwi
خورما=date
لیمۆ=lemon
تەماتە=tomatos
پیااز=onion
سیر=garlic
فاسۆلیا=bean
قەنەفە=sofa
کورسی=chair
مێز=table
پێخەف=bed
دۆڵابی جل=wardrobe
گەرمکەرەوە=heater
پیاهەڵدان=oven
چەقۆ=knife
کەوچک=spoon
چەنگاڵ=fork
تاوەن=pan
قاپ=dishes
قاپەکان=plates
چا=tea
ڕۆن=oil
شەکر=sugar
خوێ=salt
ئارد=flour
نان=bread
نەهەنگ=whale
هەڵۆ=eagle
باز=hawk
بۆق=frog
بزن=goat
بەراز=pig
بەرخ=lamb
مشک=mice
باڵندە=bird
وشتر=camel
فیل=elephant
مانگا=cow
مەیمون=monkey
گورگ=wolf
ئەسپ=horse
وورچ=bear
مشک=mouse
پشیلە=cat
مەڕ=sheep
ڕێوی=fox
کیسەڵ=turtle
سەگ=dog
تیمساح=crocodile
زێبرا=zebra
زەڕافە=giraffe
مراوی=duck
بیکینی=bikini
کابۆی=jeans
سڵاو=hello
چۆن=how
تۆ=you
من=I
ئێمە=we
ئەوان=they
ئەو=she
ئەو=he
تەمەن=age
ناو=name
تۆ=your
کانگا=mine
ئەو=her
هی تۆ=yours
شار=city
لادێ=village
ڕێگا=road
کێو=mountain
خۆر=sun
مانگ=moon
کەش و هەوا=weather
گڵۆپ=light
درەوشاوە=bright
تاریک=dark
سێبەر=shadow
بەرد=stone
درەخت=tree
ڕووبار=river
قوتابخانە=school
زانکۆ=university
خوێندکار=student
مامۆستا=teacher
پاس=bus
ئۆتۆمبیل=car
پەرتووک=book
قەڵەم=pencil
پاککەرەوە=eraser
دەفتەر یاداشت=notebook
هەڵبژاردن=election
سەرۆک=president
خواردن=eat
خواردنەوە=drink
برسی=hungry
تینوو=thirsty
ترس=afraid
دڵخۆش=happy
دڵەڕاوکێ=anxious
خەمبار=sad
کاتژمێر=hour
باشە=good
بەیانی=morning
پاش نیوەڕۆ=afternoon
شەو=night
خەوتن=sleep
بەئاگا=awake
پیاسەکردن=walking
ڕاکردن=running
دانیشتن=sitting
قسەکردن=talking
قسەکردن=speaking
فێربوون=learning
خوێندنەوە=reading
نووسین=writing
خوێندن=studing
گۆرانی وتن=singing
تەقەکردن=shooting
قیژە=shout
کوژاندنەوە=shut
خوارەوە=down
سەرەوە=up
ناوەوە=inside
دەرەوە=outside
نزیک=near
داخستن=close
یاکین=close
کردنەوە=open
دوور=far
نیوە=half
پڕ=full
بەتاڵ=empty
ئاو=water
ئاگر=fire
قوڕ=mud
زەوی=earth
پەرداخ=bardak
کۆمپیوتەر=computer
تەختەکلیل=keyboard
بیرکاری=math
فیزیا=physics
کیمیا=chemistry
زیندەوەرزانی=biology
جوگرافیا=geography
بڵندگۆی گوێی=earphone
تەلەفۆن=phone
نەرمەواڵە=software
هاردوێر=hardware
سەنتەر=center
پەرداخ=glass
پەنجەرە=window
دەرگا=door
کڵێسا=church
مزگەوت=mosque
هەتاوی=sunny
هەور=cloudy
ڕەشەبا=windy
سەرما=cold
گەرم=hot
گەرم=warm
بنێشت=gum
ددان=teeth
فڵچەی ددان=toothbrush
کڵاو=hat
گۆرەوی=socks
پێڵاو=shoes
پانتۆڵ=trouser
چاکەت=jacket
بۆینباخ=tie
پۆشاک=dress
چاویلکە=eyeglasses
چاویلکەی هەتاوی=sun glasses
تەنورە=skirt
جلی ژێرەوە=underwear
بێجام=pajams
گۆزە=jar
چێشتخانە=restaurant
چێشتلێنان=cook
بڕین=cut
کورت=short
درێژ=long
کۆن=old
نوێ=new
دار=wood
بارهەڵگر=truck
چەرخ=wheel
دکتۆر=doctor
پەرستار=nurse
پۆلیس=police
سەرباز=soldier
تفەنگ=gun
گوللە=bullet
تانک=tank
فڕۆکە=plane
هێڵی ئاسمانی=airline
فڕۆکەخانە=airport
شۆفێر=driver
دزی=steal
دز=robber
هاتوچۆ=traffic
فەرەنسا=france
ئەڵمانیا=germany
بەریتانیا=britan
ئەمریکا=america
بەڕازیل=brasil
نەرویج=norway
تورکیا=turkey
عێراق=iraq
کوردستان=kurdistan
ڕووسیا=russia
چین=china
ژاپۆن=japan
ئێران=iran
ئەفریقا=africa
ئاسیا=asia
ئەوروپا=europe
کەنەدا=canada
ئینگلیزی=english
تورکی=turkish
کوردی=kurdish
ئەڵمانی=german
فەرەنسی=french
هێندستان=india
موسڵمان=muslim
مەسیحی=christian
خودا=god
گوناه=sin
خراپ=bad
فریشتە=angel
جیهان=world
شوان=shepherd
ئاگرکوژێنەوە=fireman
پارێزەر=lawyer
خزمەتکار=waiter
دەریا=sea
ماسی=fish
کەشتی=ship
کلیل=key
جزدان=wallet
پارە=money
زێڕ=gold
زیو=silver
باش=well
گوڵ=flower
گژوگیا=grass
دەرمان=medicine
دەسپێکردن=start
کۆتایی=end
وەستان=stop
برنج=rice
سابوون=soap
شۆربا=soup
سەلاجە=refrigerator
ئەلفوبێ=alphabet
ڕەنگەکان=colors
ئاڵا=flag
دەستەسڕ=napkin
خاولی=towel
سەرتاش=hairdresser
فیلم=film
فیلم=movie
کوشتن=kill
ماچ=kiss
لێدان=beat
قەپ=bite
نەخۆش=sick
تەندروست=healthy
منداڵ=children
خێزان=family
سوپا=army
ئیش=work
مەکتەب=office
زمان=language
بێگانە=foreign
بێگانە=alien
بۆشایی=space
سروشت=nature
ڕاوچی=hunter
ڕاوکردن=hunt
کۆتر=pigeon
بەندیخانە=prison
خۆڕایی=free
شەڕ=war
ئاشتی=peace
نەورۆز=newroz
شیر=milk
هەنگوین=honey
خانوو=house
باخچە=garden
هەنار=pomegranate
گەڵا=leaf
گۆشت=meat
مریشک=hen
مریشک=chicken
پەڕگە=file
ئەرک=task
ئەرک=duty
بەرپرسیارێتی=responsibility
عیناد=stubborn
بەخشندە=generous
بۆگەنی=stinky
خۆپەرست=selfish
بۆن کردن=smell
تامکردن=taste
بینین=see
بیستن=hear
پشتگوێ خستن=ignore
دڵ=heart
خۆشەویستی=love
ڕق لێبوونەوە=hate
ژنان=women
پیاو=man
ئاژەڵ=animal
پیشاندان=show
دووکەڵ=smoke
میوە=fruit
سەوزە=vegetable
کەر=donkey
کەروێشک=rabbit
پەردە=curtain
شەقام=street
کارتۆنی=cartoon
ڕۆژی لەدایک بوون=birthday
پاسکیل=bike
خاک=land
گەنم=wheat
جۆ=barley
بابونە=camomile
ئەندازیار=engineer
بینا=building
هاوڕێ=friend
یارمەتی=help
کات=time
خەون=dream
تەندروستی=health
ترس=fear
خۆشی=joy
ڕاستی=truth
هیوا  =hope
ڕاکشان=lie
ئارەزوو=wish
وەکوو=like
هاوشێوە=similar
هەمان=same
ناشیرینە=ugly
جوان=beautiful
دەم و چاو=face
بەهێز=strong
لاواز=weak
بیرکردنەوە=thoughts
بیرەوەری=memory
چیرۆک=story
پرسیار=question
وەڵام=answer
گەشت=journey
سەرکێشی=adventure
شوێن=place
ئازار=pain
خۆشی=pleasure
هۆکار=reason
هەڵبژاردن=choice
پلان=plan
داهاتوو=future
ڕابردوو=past
پێشکەش کردن=present
ژیان=life
مەرگ=death
تێگەیشتن=understanding
پاشا=king
شاژن=queen
پێشەنگ=leader
پەیڕەو=follower
کێشە=problem
چارەسەر=solution
هونەر=art
تەکنۆلۆژیا=technology
بێدەنگی=silence
ژاوەژاو=noise
کەڕ=deaf
نابینا=blind
داوای لێبوردن=excuse
سەرکەوتن=victory
دەستکەوت=achievement
هێمن=calm
پشوودرێژی=patience
ئازایەتی=courage
هێز=power
سەرکەوتن=success
باوەڕ=faith
ئازادی=freedom
دادپەروەری=justice
میهرەبانی=kindness
ڕاستگۆیی=honesty
پابەندبوون=commitment
شکستهێنان=failure
سەرنەکەوتن=fail
